[console_scripts]
oslo-messaging-zmq-broker = oslo_messaging._cmd.zmq_proxy:main
oslo-messaging-zmq-proxy = oslo_messaging._cmd.zmq_proxy:main

[oslo.config.opts]
oslo.messaging = oslo_messaging.opts:list_opts

[oslo.messaging.drivers]
amqp = oslo_messaging._drivers.impl_amqp1:ProtonDriver
fake = oslo_messaging._drivers.impl_fake:FakeDriver
kafka = oslo_messaging._drivers.impl_kafka:KafkaDriver
kombu = oslo_messaging._drivers.impl_rabbit:RabbitDriver
pika = oslo_messaging._drivers.impl_pika:PikaDriver
rabbit = oslo_messaging._drivers.impl_rabbit:RabbitDriver
zmq = oslo_messaging._drivers.impl_zmq:ZmqDriver

[oslo.messaging.executors]
blocking = futurist:SynchronousExecutor
eventlet = futurist:GreenThreadPoolExecutor
threading = futurist:ThreadPoolExecutor

[oslo.messaging.notify.drivers]
log = oslo_messaging.notify._impl_log:LogDriver
messaging = oslo_messaging.notify.messaging:MessagingDriver
messagingv2 = oslo_messaging.notify.messaging:MessagingV2Driver
noop = oslo_messaging.notify._impl_noop:NoOpDriver
routing = oslo_messaging.notify._impl_routing:RoutingDriver
test = oslo_messaging.notify._impl_test:TestDriver

[oslo.messaging.pika.connection_factory]
new = oslo_messaging._drivers.pika_driver.pika_connection_factory:PikaConnectionFactory
read_write = oslo_messaging._drivers.pika_driver.pika_connection_factory:ReadWritePikaConnectionFactory
single = oslo_messaging._drivers.pika_driver.pika_connection_factory:SinglePikaConnectionFactory

[oslo.messaging.zmq.matchmaker]
dummy = oslo_messaging._drivers.zmq_driver.matchmaker.base:DummyMatchMaker
redis = oslo_messaging._drivers.zmq_driver.matchmaker.matchmaker_redis:RedisMatchMaker

